111111111111111111111111111111111
100000000000000000000000000000001
100000000000000000000000000000001
100000000000000000000000000000001
100000000000000000000000000000001
100000000000000000000000000000001
100000000000000000000000000000001
100000000000000000000000000000001
10C0C0CCC0P0000000000000000000001
10C0C000C000000000000000000000001
10CCC0CCC000000000000000000000001
1000C0C00000000000000000000000001
1000C0CCC000000000000000000000E01
100000000000000000000000000000001
111111111111111111111111111111111
