11111111111111111
1000000011C0001C1
10P0F000111110101
10000000000000001
1111111011F111111
1CF00C1000000C001
1C00111000F001101
1C0000000000001E1
11111111111111111
